
//GUARDARE COME HANNO FATTO GLI ALTRI, SE VALE LA PENA CONTINUARE COSI ALLORA:
	- FINIRE BENE LE DIREZIONI CON UNO SPAZIO (CONSIDERARE ANCHE LE CASISTICHE PIPE)



- MI DEVO SEGNARE LA DIREZIONE ATTUALE E QUELLA DA CUI VENGO

- MI DEVO SEGNARE LE COORDINATE DEI 4 PUNTI ESTREMI DELLA MAPPA ED INIZIO DA SINISTRA VERSO DESTRA IN SENSO ORARIO.

- CONSIDERO LE CASISTICHE IN QUESTO ORDINE:
	- 3 SPAZI:

	- 2 SPAZI:
		- SE HA LO SPAZIO SOPRA E A DESTRA: IN QUESTO CASO LA DIREZIONE DI SCORRIMENTO È SEMPRE VERSO DESTRA (→) QUINDI DEVO SEMPRE CAMBIARE LA DIREZIONE VERSO IL BASSO.
		- SE HA LO SPAZIO SOPRA E A SINISTRA: IN QUESTO LA DIREZIONE DI SCORRIMENTO È SEMPRE VERSO L'ALTO (↑) QUINDI DEVO CAMBIARE LA DIREZIONE VERSO DESTRA
		- SE HA LO SPAZIO SOTTO E A SINISTRA: IN QUESTO LA DIREZIONE DI SCORRIMENTO È SEMPRE VERSO SINISTRA (←) QUINDI DEVO CAMBIARE LA DIREZIONE VERSO L'ALTO
		- SE HA LO SPAZIO SOTTO E A DESTRA: IN QUESTO LA DIREZIONE DI SCORRIMENTO È SEMPRE VERSO IL BASSO (↓) QUINDI DEVO CAMBIARE LA DIREZIONE VERSO SINISTRA
	
	- 1 SPAZIO:
		
		- SE HA LO SPAZIO SOLO A DESTRA:
			- SE L'1 PRIMA AVEVA LO SPAZIO VERSO DESTRA ALLORA PROSEGUO VERSO IL BASSO (↓)			OK
				
				11111
				10001
				10001
				11111
			
			- SE L'1 PRIMA AVEVA LO SPAZIO VERSO SINISTRA ALLORA PROSEGUO VERSO IL BASSO (↓)		OK
				
				11111
				100 11
				10001
				11111
			
			- SE L'1 PRIMA AVEVA LO SPAZIO VERSO L'ALTO ALLORA PROSEGUO VERSO L'ALTO (↑)			OK
				
				111111  1111                
				100001111 11 
				111111111111

			- SE L'1 PRIMA È UN END PIPE ORIZZONTALE PERPENDICOLARE ALLORA VADO VERSO L'ALTO 	(↑)			OK
				
				11111     1111                
				10000111111 11 
				1111111   1111


		- SE HA LO SPAZIO SOLO A SINISTRA: 
		- SE L'1 PRIMA AVEVA LO SPAZIO VERSO SINISTRA ALLORA PROSEGUO VERSO L' ALTO (↑)			OK
		
		- SE HA LO SPAZIO SOLO SOTTO:
			- SE L'1 PRIMA AVEVA LO SPAZIO SOLO SOTTO ALLORA PROSEGUO VERSO SINISTRA (←)	OK
			- SE L'1 PRIMA AVEVA LO SPAZIO VERSO DESTRA ALLORA PUNTO SU QUELLO A DESTRA (→)	OK	
			- SE L'1 PRIMA AVEVA LO SPAZIO SOLO SOPRA ALLORA PROSEGUO VERSO SOPRA (↑)		OK
			
		- SE HA LO SPAZIO SOLO SOPRA: 
			- SE L'1 PRIMA AVEVA LO SPAZIO SOLO SOPRA ALLORA PROSEGUO VERSO DESTRA (→)		OK
			- SE L'1 PRIMA AVEVA LO SPAZIO SOLO SOTTO ALLORA PROSEGUO VERSO DESTRA (→)		OK
			- SE L'1 PRIMA AVEVA LO SPAZIO VERSO SINISTRA ALLORA PROSEGUO VERSO DESTRA (→)	OK

	        1111111111 1111
111111      111111 1001
110101      1111111                
1100 11111111 111 1                    
     11111  1111111              
			 
			 111      111  111                         
111111111111111  111                    
111011110N011111111


							111111111111111
						111111  11111  1001
						1101011110011  1001                
						1100000000111  1111                  
				111111111 100N0010001    111                         
					11111101010010001   111                    
						111111111111111111 

	1111111111  1111
111111  111111  11001
110101  100011  1  1011                
1100000011111111111                    
           11 1  111                         
           11 1  111                    
111011110N011111111




			1111          
11111    11 11 11
11111    11 11 11
11111    11 11 11
11111    11 11 11
11111111111111111
      11        



	
	- 0 SPAZI:
		- APPENA TROVO UN 1 CHE NON HA SPAZI INTORNO DEVO CONSIDERARE LA DIREZIONE DA CUI VENGO (QUINDI SE LA DIREZIONE DI SCORRIMENTO DEI MURI AD ESEMPIO È DESTRA, LA DIREZIONE DA CUI VENGO È SINISTRA) E GUARDARE SUBITO ALL' 1 DEL SENSO SUCCESSIVO (IN SENSO DI SCORRIMENTO ORARIO).
		SE TROVO UNA PIPE DI MURI LA ESCLUDO (UN 1 CON SPAZI SOPRA E SOTTO OPPURE SPAZI A DESTRA E SINISTRA). UNA PIPE PUO PARTIRE SOLO DA 

		SE TROVO UN 1 PIPE TORNO INDIETRO DI 1 E DOVE C'ÈRA L'1 PIPE LO CONSIDERO SPAZIO






CONDIZIONI PER SCORRERE I MURI DA SINISTRA A DESTRA, DALL' ALTRO VERSO IL BASSO:
LE PIPE DI MURI NON LE CONSIDERO. 
METTO UN FLAG SE È UN PIPE DI MURI, OVVERO SE HA GLI SPAZI SOPRA E SOTTO OPPURE A DESTRA E SINISTRA. IN QUESTO CASO SCORRO NELLA DIREZIONE SPECIFICA FINCHE SONO TUTTI 1 E FINCHE GLI SPAZI CONTINUANO A STARE NELLE LORO POSIZIONI. TROVATO UN NODO PIPE, UN 1 DOVE C'È UN ANGOLO, QUINDI GLI SPAZI STARANNO IN PUNTI DIVERSI, TOLGO IL FLAG PIPE E TROVO L'ALTRA DIREZIONE (OVVIAMENTE CONTROLLO SE È UN ALTRA PIPE). ALLA FINE TROVERÒ UN 1 CHE HA 3 SPAZI INTORNO. ARRIVATO LI TORNO AL NODO DA DOVE È PARTITA LA PIPE DI 1 

CONTROLLO I CASI 



1 - SE LO SPAZIO STA SOLO SOPRA--> 2 CASI:
	
	1.1 NON C'È PIU SPAZIO SOPRA--> CONTROLLO SE QUELLO SOPRA L'1 DOVE STO POSIZIONATO È UN 1, QUINDI INIZIO A SCORRERE VERSO L'ALTO
	
	1.2 SE SOPRA C'E ANCORA SPAZIO MA A DESTRA NO--> CONTROLLO SE ANCHE SOTTO C'È UNO SPAZIO, SE SI TORNO INDIETRO 

2 - SE LO SPAZIO STA SOPRA E A DESTRA--> VAI SOTTO DI UNO


			 F   32,		101,  42

C			225,	30, 0

		NO ./path_to_the_north_texture

                                    WE     ./path_to_the_west_texture
    SO				./path_to_the_south_texture

					EA 		  	./path_to_the_east_texture     




11111111111111011100000010001                        1          1 1   1   1  1     1
11110111111111011101010010001                        1          1 11111   1  1     1
11000000110101011100000010001                     1111111       1         1  1     1
10000000000000001100000010001                         111111    11111111111  1111111
10000000000000001101010010001                        1111
11000001110101011111011110N0111					       1	
11110111 1110101 101111010001                          1
11111111 1111111 111111111111
					    111111
		            11111111111 

					           1			    
1111111111111111     11         1     1        
10000000000000111111111111111111 111111111                                    1111111
101111111111100011110000001110111                                            111   1
101		   1000000000110000000000111                                            111   1
101        1011000001110000000000001                    1111111111111111111111111     1
101       10010000000000000000000011111111111111111111111111111               1     1
11111111111111101100000111000000000000111111111111111111111111111111     11111111111  1  1
   11 111011000001110111111101111                  1           1     1   1  1     1
1111111111111101110001  1000 11                   1          1 1   1   1  1     1
1111011111111101110101  1000 111                 1          1 11111   1  1     1
1100000011010101110000001111111111                    1111111       1         1  1     1
10000000000000001100000010001 11111                         111111    11111111111  1111111
10000000000000001101010010001   111                     1111
11000001110101011111011110N01111111					       1	
11110111 1110101 101111010001                          1111111111111111111111111111
11111111 1111111 111111111111

111     111    111
111     111    111
1111111111111111111111 
1111100011110000111111111
1000000000110000000000001
1011000001110000000000001
1001000000000000000000001
1111111110110000011100000111111
100000000011000001110111111111111
11110111111111011100000010001
11110111111111011101010010001
11000000110101011100000010001
10000000000000001100000010001
10000000000000001101010010001
11000001110101011111011110N0111
11110111 1110101 101111010001
11111111 1111111 111111111111


111111111011111111111111 
1111100011110000111111111
1000000000110000000000001
1011000001110000000000001
1111000000000000000000001
   111110110000011100000111111
1111000000011000001110111111111111
11110111111111011100000010001
11110111111111011101010010001
11000000110101011100000010001
10000000000000001100000010001
10000000000000001101010010001
11000001110101011111011110N0111
11110111 1110101 101111010001
11111111 1111111 111111111111

 111111111111
     110000111  
      1100000111
	 1110001111
1111111111111

