NO 11100101
WE ./path_to_the_west_texture
SO ./path_to_the_south_texture
 C 
  		 F  		  	 256, 		 	 21,11
  EA ./path_to_the_east_texture

 	 
	 	 
		 	 
011111111111
11111N11111111
 	 	 		 	 	 	 	 11111111
11111111
 		 1111110111
