
//GUARDARE COME HANNO FATTO GLI ALTRI, SE VALE LA PENA CONTINUARE COSI ALLORA:
	- FINIRE BENE LE DIREZIONI CON UNO SPAZIO (CONSIDERARE ANCHE LE CASISTICHE PIPE)



- MI DEVO SEGNARE LA DIREZIONE VERSO CUI VADO E QUELLA DA CUI VENGO

- MI DEVO SEGNARE LE COORDINATE DEI 4 PUNTI ESTREMI DELLA MAPPA ED INIZIO DA SINISTRA VERSO DESTRA IN SENSO ORARIO.

- PARTENDO DAL PUNTO PIU ALTO A SINISTRA ED INIZIO AD ANDARE VERSO DESTRA

- ANALISI 4 DIREZIONI:

	- DIREZIONE VERSO DESTRA (⇨), SPAZIO SOLO SOPRA . 3 SITUAZIONI DI BLOCCO:

		- L'UNO DOVE MI TROVO FORMA UN ANGOLO ESTERNO, OVVERO HA LO SPAZIO SOPRA E A DESTRA, QUINDI DEVO SCENDERE (↴)
		- L'UNO DOVE MI TROVO FORMA UN ANGOLO INTERNO, QUINDI NON HA SPAZI DA NESSUN LATO E, VISTO CHE LA DIREZIONE ERA VERSO DESTRA DEVO SALIRE. (⤴)
		- L' UNO DOVE MI TROVO È AD UN PUNTO MORTO, QUINDI HA 3 SPAZI (SOPRA, A DESTRA E IN BASSO). A QUESTO PUNTO MI BASTA INVERTIRE LA DIREZIONE. (↻)

	- DIREZIONE VERSO SINISTRA (⇦), SPAZIO SOLO SOTTO . 3 SITUAZIONI DI BLOCCO:

		- L'UNO DOVE MI TROVO FORMA UN ANGOLO ESTERNO, OVVERO HA LO SPAZIO SOTTO E A SINISTRA, QUINDI DEVO SALIRE (⬑)
		- L'UNO DOVE MI TROVO FORMA UN ANGOLO INTERNO, QUINDI NON HA SPAZI DA NESSUN LATO E, VISTO CHE LA DIREZIONE ERA VERSO SINISTRA DEVO SCENDERE. (⬐)
		- L' UNO DOVE MI TROVO È AD UN PUNTO MORTO, QUINDI HA 3 SPAZI (SOTTO, A SINISTRA E IN ALTO). A QUESTO PUNTO MI BASTA INVERTIRE LA DIREZIONE. (↻)

	- DIREZIONE VERSO IL BASSO (↓), SPAZIO SOLO A DESTRA. 3 SITUAZIONI DI BLOCCO:

		- L'UNO DOVE MI TROVO FORMA UN ANGOLO ESTERNO, QUINDI HA SPAZIO A DESTRA E IN BASSO. DEVO GIRARE A SINISTRA (↲)
		- L'UNO DOVE MI TROVO FORMA UN ANGOLO INTERNO, QUINDI NON HA NESSUNO SPAZIO DA NESSUN LATO. DEVO GIRARE A DESTRA (↳)
		- L' UNO DOVE MI TROVO È AD UN PUNTO MORTO, QUINDI HA 3 SPAZI (A DESTRA, A SOTTO E A SINISTRA). A QUESTO PUNTO MI BASTA INVERTIRE LA DIREZIONE. (↻)

	- DIREZIONE VERSO L'ALTO (↾), SPAZIO SOLO A SINISTRA. 3 SITUAZIONI DI BLOCCO:

		- L'UNO DOVE MI TROVO FORMA UN ANGOLO ESTERNO, QUINDI HA SPAZIO A SINISTRA E IN ALTO. DEVO GIRARE A DESTRA (↱)
		- L'UNO DOVE MI TROVO FORMA UN ANGOLO INTERNO, QUINDI NON HA NESSUNO SPAZIO DA NESSUN LATO. DEVO GIRARE A SINISTRA (↰)
		- L' UNO DOVE MI TROVO È AD UN PUNTO MORTO, QUINDI HA 3 SPAZI (A DESTRA, A SOPRA E A SINISTRA). A QUESTO PUNTO MI BASTA INVERTIRE LA DIREZIONE. (↻) 


			 F   32,		101,  42

C			225,	30, 0

		NO ./path_to_the_north_texture

                                    WE     ./path_to_the_west_texture
    SO				./path_to_the_south_texture

					EA 		  	./path_to_the_east_texture     




11111111111111011100000010001                        1          1 1   1   1  1     1
11110111111111011101010010001                        1          1 11111   1  1     1
11000000110101011100000010001                     1111111       1         1  1     1
10000000000000001100000010001                         111111    11111111111  1111111
10000000000000001101010010001                        1111
11000001110101011111011110N0111					       1	
11110111 1110101 101111010001                          1
11111111 1111111 111111111111
					    111111
		            11111111111 

					           1			    
1111111111111111     11         1     1        
10000000000000111111111111111111 111111111                                    1111111
101111111111100011110000001110111                                            111   1
101		   1000000000110000000000111                                            111   1
101        1011000001110000000000001                    1111111111111111111111111     1
101       10010000000000000000000011111111111111111111111111111               1     1
11111111111111101100000111000000000000111111111111111111111111111111     11111111111  1  1
   11 111011000001110111111101111                  1           1     1   1  1     1
1111111111111101110001  1000 11                   1          1 1   1   1  1     1
1111011111111101110101  1000 111                 1          1 11111   1  1     1
1100000011010101110000001111111111                    1111111       1         1  1     1
10000000000000001100000010001 11111                         111111    11111111111  1111111
10000000000000001101010010001   111                     1111
11000001110101011111011110N01111111					       1	
11110111 1110101 101111010001                          1111111111111111111111111111
11111111 1111111 111111111111

111     111    111
111     111    111
1111111111111111111111 
1111100011110000111111111
1000000000110000000000001
1011000001110000000000001
1001000000000000000000001
1111111110110000011100000111111
100000000011000001110111111111111
11110111111111011100000010001
11110111111111011101010010001
11000000110101011100000010001
10000000000000001100000010001
10000000000000001101010010001
11000001110101011111011110N0111
11110111 1110101 101111010001
11111111 1111111 111111111111


111111111011111111111111 
1111100011110000111111111
1000000000110000000000001
1011000001110000000000001
1111000000000000000000001
   111110110000011100000111111
1111000000011000001110111111111111
11110111111111011100000010001
11110111111111011101010010001
11000000110101011100000010001
10000000000000001100000010001
10000000000000001101010010001
11000001110101011111011110N0111
11110111 1110101 101111010001
11111111 1111111 111111111111

 111111111111
     110000111  
      1100000111
	 1110001111
1111111111111

