NO qweqw
WE ./path_to_the_west_texture
SO ./path_to_the_south_texture
C 
F  		  	 253, 		 	 21,11
EA ./path_to_the_east_texture

1111110   W1101010E
WSEN11W   NS0EW1111    
1111111       01111
1002110       S0001 
900311E111W234N6001
9003111111111111001
NWS0111110111110001