NO 11100101
WE ./path_to_the_west_texture
SO ./path_to_the_south_texture
 C 
 F 	
  EA ./path_to_the_east_texture

 	 
	 	 
		 	 
011111111111
11111111111110
10000000f0110


