NO qweqw
WE ./path_to_the_west_texture
SO ./path_to_the_south_texture
C 
F  		  	 253, 		 	 21,11
EA ./path_to_the_east_texture

 	1
2000000001
1000000001
1100000001
1111000001
1000000001
1000000001
1111111111

