NO ./path_to_the_north_texture	 	 	 	
SO ./path_to_the_south_texture	 	 
WE ./path_to_the_west_texture	 	 
EA ./path_to_the_east_texture	 	 	 	 
F 220,100,0 			 
C 225,30,0 		
 	 	 	 	 

1111111111111111111111111
10000000001110000100000001
10110000011110000000000001
1010000			0000000000000001
111111111011000001110000000000001
100000000011000001110111111111111
11110111111111011100000010001
111000000110101011100000010001
10000000000000001100000010001
	10000000000000001101010010001
	1100000111111111110101011111111110111100111
11110111 1110101 101111010001
11111111 1111111 111111111111
000000000000000000000000000000
