NO qweqw
WE ./path_to_the_west_texture
SO ./path_to_the_south_texture
C 
F  		  	 253, 		 	 21,11
EA ./path_to_the_east_texture

1111N
10001
10001
11111