NO qweqw
WE ./path_to_the_west_texture
SO ./path_to_the_south_texture
C 
F  		  	 253, 		 	 21,11
EA ./path_to_the_east_texture
1111111111111 
1000000000001
1000000000001 	
100N000000001
1111111111111
